11x11
000WW_W0000
000WW_W0000
000WW_W0000
000WW_W0000
WWWWW_WWWWW
___________
WWWWW_WWWWW
0000W_W0000
0000W_W0000
0000W_W0000
0000W_W0000
